1111111111111111111111111111111111111111
1111111111116666111100000000000000000000
1111111111116666111100000000000000000000
1111111111116666111100000000000000000000
1111111111110000111100000000000011111111
1111111111110000111100000000000011111111
1111111111110000111100000000000011111111
1111111111110000111100000000000011111111
1111111111110000111111110000000011111111
1111111111110000000000000000000011111111
1111111100110000000000000000000011111111
1111111100110000000000000000000011111111
1111111111111111000000000000000011111111
1111111100000000000000000000000011111111
1111111100000000000000000000000011111111
1111111100000000000000000000000011111111
1111111100000000000000000000000011111111
1111111111111111111111111111111111111111
1111111111111111111111111111111111111111
1111111111111111111111111111111111111111
055.