1111111111111111000000001111111111111111
1111111111111111000000001111111111111111
1111111111111111000000001111111111111111
1111111111111111000000001111111111111111
1111111111111111000000001111111111111111
1111111111111111000000001111111111111111
1111111111111111115555111111111111111111
1111111111111111115555111111111111111111
1111111111111111110000111111111111111111
1111111111111111000000001111111111111111
1111111111111111000000001111111111111111
1111111111111111000000001111111111111111
1111111111111111000000001111111111111111
1111111111111111000000000000000000**0000
0000001111110000000000000000000000**0000
0000001111110000000000000000000000**0000
0000000011111100000000000000000000**1111
0000000011111111111111111111111111111111
1111111111111111111111111111111111111111
1111111111111111111111111111111111111111
3413