1111111111111111111111111111111111111111
1111111111110000000000111111111111111111
0000000011110000000000111111111111111111
0000000011110000000000111111111111111111
1111111111110011111100111111111111111111
0000000000000011111100111111111111111111
0000000000000011111111111111111111111111
0000000000000011111111111111111111111111
1111111100001111111111111111111111111111
1111111100001111114411111111111111111111
0000111111000011114411111111111111111111
0000111111000000004411111111111111111111
1100000000110000000011111111111111111111
0100000000110000000011111111111111111111
0011111111111100001111111111111111111111
1111111111111100001111111111111111111111
1111110000000011111111111111111111111111
1111110000000011111111111111111111111111
1100000000000011110000111111111111111111
1100000000000011110000111111111111111111
0313