1111111111111111111111110000000000000011
1111111111111111111111110000000000000011
1111111111111111111111110000000000000011
1111111111111111111111110000000000000011
1111111111111111111111110000000000000011
0000000000000000000000000000000000000011
0000000000000000000000000000000000000011
0000000000000000000000000000000000000011
0000000000000000000000000000000000000011
0000000000000000000000000000000000000011
0000000000000000000000000000000000000011
0000000000000000000000000000000000000011
0000000000000000000000000000000000000011
1111111111111111111111111111111111111111
1111111111111111111111111111111111111111
1111111111111111111111111111111111111111
1111111111111111111111111111111111111111
1111111111111111111111111111111111111111
1111111111111111111111111111111111111111
1111111111111111111111111111111111111111
0000