1111111111110000000000001111111111111111
0000000000000000000000001111111111111111
0000000000000000000000001111111111111111
0000000000000000000000001111111111111111
1111111111110000000000001111111111111111
1111111111110000000000001111111111111111
1111111111110000000000001111111111111111
1111111111110000000000001111111111111111
1111111111110000000000001111111111111111
1111111111110000000000001111111111111111
1111111111110000000000001111111111111111
1111111111110000000000001111111111111111
1111111111110000000000001111111111111111
1111111111110000000000001111111111111111
1111111111110000000000001111111111111111
1111111111110000000000001111111111111111
1111111111110000000000001111111111111111
1111111111110000000000001111111111111111
1111111111111111000000001111111111111111
1111111111111111000000001111111111111111
0000