1111000000001111111111111111111111111111
1111000000001111111111111111111111111111
1111000000001111111111111111111111111111
1111000000001111111111111111111111111111
1111000000001111111111111111111111111111
1111000000001111111111113311111111111111
1111000000001111111111113311111111111111
1111000000000000000011110011111111111111
1111000000000000000011110011111111111111
1111000000001111110000000011111111111111
1111000000001111110000000011111111111111
1111000000001111111111111111111111110011
1111000000001111111111111111111111110011
1111000000001111111111111111110000000011
1111000000001111111111111111110000000011
1111000000000000001111110000000000000011
1111000000000000001111110000000000111111
1111000000000000001111110000000000111111
1111111111110000001111110000000000111111
1111111111110000001111110000000000111111
026.