1111111111111111111111111111111111111111
1111111111111111111111111111111111111111
1111111111111111111111111111111111111111
1111111111111111111111111111111111111111
1111111111111111111111111111111111111111
1111111100000000000002200000000000000000
1111111100000000000002200000000000000000
1111111100000000000002200000000000000000
1111111100000000000011110000000000000000
1111111100000000000011110000000000000000
1111111100000000000011000000000000000000
1111111100000000000011000000000000000000
1111111100000000001111000000000000000000
1111111111111111111111111111111111111111
1111111111111111111111111111111111111111
1111111111111111111111111111111111111111
1111111111111111111111111111111111111111
1111111111111111111111111111111111111111
1111111111111111111111111111111111111111
1111111111111111111111111111111111111111
0114