1100110000000000000000000000000000110011
1100110000000000000000000000000000110011
1100000000000000000000000000000000000011
1100000000000000000000000000000000000011
1100000000000000000000000000000000000011
1100000000000000000000000000000000000011
1100110000000000000000000000000000110011
1100110000000000000000000000000000110011
1100000000000000000000000000000000000011
1100000000000000000000000000000000000011
1100000000000000000000000000000000000011
1100000000000000000000000000000000000011
1100110000000000000000000000000000110011
1100110000000000000000000000000000110011
1100000000000000000000000000000000000011
1100000000000000000000000000000000000011
1100110011777777777777777777110011001111
1100110011777777777777777777110011001111
1111001100117777777777777711001100110011
1111001100111111111111111111001100110011
064.