1111110011110000001111110000000000111111
1111110011110000001111110000000000111111
1111111111110000001111110000000000111111
1111111111110000000011110000000000111111
1111111111110000000011110000000011111111
1111111100000000000011110000000111111111
11111111000000000000****0000001111111111
11111111000000000000****0000001111111111
11111111000000000000****0000001111111111
1111111100000000000011110000001111111111
11111111000000000000111100000011m1100011
1111000000000000000011110000000000000011
1111000000000010111111110000000000000011
0000000000000000111111110000000000000011
0000000011111111111111110000000000000011
0000000011111111111111110000000000000011
1111111111111111111111110000000000000011
1111111111111111111111111100000000000011
1111111111111111111111111100000000000011
1111111111111111111111111100000000000011
0000