1111111111111111111111111111111111111111
1111111111111111111111111111111111111111
1111111111111111111111111111111111111111
1111111111111111110000000000000000011111
1111000000000000000000000000000000011111
1111000000000000000000000000000000011111
1111001110000000000000000000110000011111
1111001110000000000000000000110000011111
1111001110000011111111000000110000011111
1111000000000011111111000000110000011111
1111000000000011111111000000000000011111
1111000000000011111111000--0000000011111
1111000000000000000000000--0000000011111
1111000000000000000000000000000000011111
1111110000000000000000000000000000111111
1111110000000000000000000000000000111111
1111110000000000000000000000000000111111
1111111111111100111111111111111111111111
11111111111111mm111111111111111111111111
1111111111111111111111111111111111111111
0000