0011001111111100111111111100000000000011
0011001111111100111111111100000000000011
1111111111111111111111111100000000000011
1111111111111111111111111100000000000011
1111111111111111111111111111000000000011
1111111111111111111111111111000000000011
1111111111111111111111111111000000000011
1111111111111111111111111111000000000011
1111111111111111111111111111000000000011
1111111111111111111111111111000000000011
1111111111111111111111110000000011000011
1111111111111111111111110000000011000011
1111111111111111111111110000000011000011
1111111111111111111111110000000011000011
1111111111111111111111110000000011000011
1111111111111111111111110000000011000011
1111111111111111111111110000000011000011
1111111111111111111111110000000000000011
1111111111111111111111110000000000000011
1111111111111111111111110000000000000011
0000