1111111111111111****11111111111111111111
1111111111111111****00000000111111111111
1111111111111111000000000000111111111111
1111111111110000000000000000111111111111
1111111111110000000000000000111111111111
1111111111110000000000000000111111111111
1111111111110000000000000000111111111111
1111111111110000000000000000111111111111
1111111111110000000000000000111111111111
1111111111110000000000000000111111111111
1111111111110000000000000000111111111111
1111111111110000000000000000111111111111
1111111111110000000000000000111111111111
1111111111110000000000000000111111111111
1111111111110000000000000000111111111111
1111111111110000000000000000111111111111
1111111111110000000000000000111111111111
1111111111110000000000001111111111111111
1111111111110000000000001111111111111111
1111111111110000000000001111111111111111
4000