1111111111111111111111111111111111111111
1111000000000000000000000011111111111111
1111000000000000000000000011111111001111
1111000000000000000000000010000000101111
1111000000000000000000001100000000111111
1111000000000000000000001100000000000001
11110000000000000000001111**111100000000
11110000000000000000001111**111100000000
1111000000000000001111111100111111111111
1111000000000000000000110000111111111111
1111000000000000000000110000001111110000
1111000000000000000000110000001111110000
1111000000000000001100000011000011111111
1111000000000000001100000011000000000000
1111000000000000000011111111000000000000
1111000000001111111111111111111111111111
1111000000001111111111111111111111111111
1111000000001111111111111111111111111111
1111000000001111111111111111111111111111
1111000000001111111111111111111111111111
2000