1111111111111111111111111111111111111111
1111111111111111111111111111111111111111
1111111100000000000000000000000000001111
1111111100000000000000000000000000001111
1111110000000000000000000000000000000011
1111110000000000000000000000000000000000
1111000000000000000000000000000000000000
1111000000000000000000000000000000111111
1111110000000000000000000000000000111111
1111110000000000000000000000000000111111
1111000000000000000000000000000000001111
1111000000000000000000000000000000001111
1100000011000000000000000000110000000011
1100000011000000000000000000110000000011
1100110000000000000000000000000000110011
1100110000000000000000000000000000110011
1100110000000000000000000000000000110011
1100110000000000000000000000000000110011
1100000000000000000000000000000000000011
1100000000000000000000000000000000000011
0000